1111111111111111111111111111111111111111
1000000001000010001111010000101010101011
1000000000011100001111011100101010001001
1000000001000000111110001110000000411001
1000000001111110111111010000111111440011
1000000201111100000011000011150004000111
1000000000000000001111000111111110000001
1000002001111111000000011111111111111101
1000000201111111111400000000111111000001
1400000000311111111141110000000000001111
1144111131111111111111111113311111111111
1111111111111111111111111111111111111111
