1111111111111111111111111111111111111111
1000000001000010001111010000101010101011
1000000000011100001111011100101010001001
1000000001000000111110001110000000111001
1000000001111110111111010000111111110011
1000000101111100000011000011110000000111
1000000000000000001111000111111110000001
1000001001111111000000011111111111111101
1000000101111111111100000000111111000001
1100000000111111111111110000000000001111
1111111111111111111111111111111111111111
1111111111111111111111111111111111111111
