1111111111111111111111111111111111111111
1000001114411111111111111111100001111111
1000111114441000000011111111000222000111
1001111100000001111000211110000000000011
1100000114111111110002111111110110011111
1111110011100001110021111111110111001111
1133111011001100000000011110000110011111
1100110000011111100011000000111111000011
1110000111444000001113111000001100011111
1111111155111111110004441100000111000011
1111111144000000000011000000011111444111
1111111111111111111111111111111111111111
